  XXXXXXXXXXX
 XX     X  @X
XXX * **X   X
X XX*    ** X
X  X  * X   X
XXXXXX XXXXXX
X.. ..* X*XX
X ..    XXX
X  ..XXXXX
XXXXXXXXX
   
