    XXXXXXX
    X     XX
XXXXX XXX  XX
X       X  XX
X@****. XX* X
X  X    XX .X
XX  XX  X * X
 XX  XXXX.*.X
  XX        X
   XXXXXX  XX
        XXXX