           XXXXXX
    XXXX  XX    X
  XXX  X  X  XX XXX
XXX    XXXX X   * X
X  * @ ...*..  *  X
X * *  XX XXX   XXX
XXX XXX   X XXXXX
 X      XXX
 X   XXXX
 XXXXX

