   XXX
  XX X XXXX
 XX  XXX  X
XX *      X
X   @* X  X
XXX *XXX  X
  X  X..  X
 XX XX.X XX
 X      XX
 X     XX
 XXXXXXX

