      XXXXXX
      X    X
      X @  XXX
XXXX  X      X
X  XXXX..X.X*XXXXX
X * * XX...      X
X     .....X**   X
XXXXXX XX*XX XXXXX
     X  *    X
     XXXX XXXX
       X  X
       X  XXXXX
     XXX *    X
     X  * *   X
     X X*X XXXX
     X     X
     XXXXXXX
