  XXXXXXXXXXX
 XX    X    XX
XXX * *X* * XXX
X X* * X * *X X
X *  ..X..  * X
X  *...X...*  X
X * .. * .. * X
XXXXXX @ XXXXXX
X * ..   .. * X
X  *...X...*  X
X *  ..X..  * X
X X* * X * *X X
XXX * *X* * XXX
 XX    X    XX
  XXXXXXXXXXX