XXXXXXXXX
X. .    X
X.*. .  X
XX XXX@ X
 X  *  XX
 X ** XX
 X  * X
 X  XXX
 XXXX