 XXXXXXXX
XX      X
X   .   #
X   *   X
X .*@*. X
XXXX*   X
   X.   X
   X   XX
   XXXXX