           XXXXX
          XX   X
          X    X
    XXXX  X * XX
    X  XXXX* *X
    X     * * X
   XX XX * * *X
   X  .X  * * X
   X  .X      X
XXXXX XXXXXXXXX
X.... @  X
X....    X
XX  XXXXXX
 XXXX
